Level ID:0001
0,7,0,0,0,4,1,3,0,9,4,5,6,1,0,0,0,0,0,0,0,0,5,7,0,0,6,0,5,0,0,3,0,0,0,4,6,9,3,0,4,0,0,0,2,4,8,2,1,0,6,0,5,7,5,0,0,3,7,0,0,6,0,0,6,0,0,0,0,0,8,1,8,0,9,5,0,0,0,7,0
Level ID:0002
0,1,3,4,2,0,0,8,6,2,0,4,6,0,0,0,0,0,0,8,7,0,1,0,3,0,0,0,0,0,0,3,0,6,0,0,0,6,2,5,0,0,0,0,3,5,0,0,7,6,4,0,9,1,7,0,0,0,4,0,8,1,0,0,4,0,8,0,0,0,6,0,0,0,1,2,5,6,0,3,7

Level ID:1001
2,0,0,0,0,6,0,0,0,1,9,5,3,0,4,0,8,7,8,0,0,1,7,0,0,0,4,0,0,0,0,0,0,3,4,0,0,0,0,8,1,0,0,2,0,0,0,0,0,0,7,0,9,0,6,7,0,0,0,0,0,3,0,0,0,0,0,5,0,0,7,0,9,5,8,0,0,3,0,0,2
Level ID:1002
0,8,0,0,2,0,0,0,0,0,0,0,0,0,0,6,8,7,0,7,0,6,0,3,2,5,0,6,0,0,1,0,0,0,0,9,0,4,0,5,9,8,1,6,0,0,9,0,0,0,4,0,3,0,9,6,0,0,7,0,0,0,0,4,0,0,0,0,0,8,0,1,8,0,0,3,0,0,0,0,0

Level ID:2001
0,0,0,0,0,0,0,0,0,0,0,4,1,6,2,9,0,0,2,0,0,0,3,0,0,7,0,0,9,0,0,0,0,0,6,3,0,0,0,0,0,0,0,0,0,0,6,0,0,1,3,0,0,7,9,0,6,0,0,5,0,0,0,8,5,0,7,0,6,4,0,0,0,7,0,0,0,0,0,2,0
Level ID:2002
0,0,2,0,0,1,0,4,9,0,8,0,0,0,0,5,0,1,3,0,0,0,0,9,0,0,0,0,0,0,0,5,0,0,0,0,0,0,0,3,9,6,2,0,0,6,0,1,0,0,4,0,0,3,0,0,3,0,0,0,0,0,2,9,0,4,0,6,0,0,0,0,0,6,0,0,2,0,0,0,0
